2
tileSet.png#12#12#64#64#3#
24#24#64#64
01-B-N-00-00-00-00#02-B-N-00-00-00-00#02-B-N-00-00-00-00#02-B-N-00-00-00-00#02-B-N-00-00-00-00#02-B-N-00-00-00-00#02-B-N-00-00-00-00#02-B-N-00-00-00-00#02-B-N-00-00-00-00#02-B-N-00-00-00-00#02-B-N-00-00-00-00#02-B-N-00-00-00-00#02-B-N-00-00-00-00#02-B-N-00-00-00-00#02-B-N-00-00-00-00#02-B-N-00-00-00-00#02-B-N-00-00-00-00#02-B-N-00-00-00-00#02-B-N-00-00-00-00#02-B-N-00-00-00-00#02-B-N-00-00-00-00#02-B-N-00-00-00-00#02-B-N-00-00-00-00#03-B-N-00-00-00-00#
13-B-N-00-00-00-00#23-F-N-00-00-00-00#23-F-N-00-00-00-00#23-F-N-00-00-00-00#23-F-N-00-00-00-00#23-F-N-00-00-00-00#23-F-N-00-00-00-00#23-F-N-00-00-00-00#23-F-N-00-00-00-00#23-F-N-00-00-00-00#23-F-N-00-00-00-00#23-F-N-00-00-00-00#23-F-N-00-00-00-00#23-F-N-00-00-00-00#23-F-N-00-00-00-00#23-F-N-00-00-00-00#23-F-N-00-00-00-00#23-F-N-00-00-00-00#23-F-N-00-00-00-00#23-F-N-00-00-00-00#23-F-N-00-00-00-00#23-F-N-00-00-00-00#23-F-N-00-00-00-00#15-B-N-00-00-00-00#
13-B-N-00-00-00-00#23-F-N-00-00-00-00#23-F-N-00-00-00-00#23-F-N-00-00-00-00#23-F-N-00-00-00-00#23-F-N-00-00-00-00#23-F-N-00-00-00-00#23-F-N-00-00-00-00#23-F-N-00-00-00-00#23-F-N-00-00-00-00#23-F-N-00-00-00-00#23-F-N-00-00-00-00#23-F-N-00-00-00-00#23-F-N-00-00-00-00#23-F-N-00-00-00-00#23-F-N-00-00-00-00#23-F-N-00-00-00-00#23-F-N-00-00-00-00#23-F-N-00-00-00-00#23-F-N-00-00-00-00#23-F-N-00-00-00-00#23-F-N-00-00-00-00#23-F-N-00-00-00-00#15-B-N-00-00-00-00#
13-B-N-00-00-00-00#23-F-N-00-00-00-00#23-F-N-00-00-00-00#23-F-N-00-00-00-00#23-F-N-00-00-00-00#23-F-N-00-00-00-00#23-F-N-00-00-00-00#23-F-N-00-00-00-00#23-F-N-00-00-00-00#23-F-N-00-00-00-00#23-F-N-00-00-00-00#23-F-N-00-00-00-00#23-F-N-00-00-00-00#23-F-N-00-00-00-00#23-F-N-00-00-00-00#23-F-N-00-00-00-00#23-F-N-00-00-00-00#23-F-N-00-00-00-00#23-F-N-00-00-00-00#23-F-N-00-00-00-00#23-F-N-00-00-00-00#23-F-N-00-00-00-00#23-F-N-00-00-00-00#15-B-N-00-00-00-00#
13-B-N-00-00-00-00#23-F-N-00-00-00-00#23-F-N-00-00-00-00#23-F-N-00-00-00-00#23-F-N-00-00-00-00#23-F-N-00-00-00-00#23-F-N-00-00-00-00#23-F-N-00-00-00-00#23-F-N-00-00-00-00#23-F-N-00-00-00-00#23-F-N-00-00-00-00#23-F-N-00-00-00-00#23-F-N-00-00-00-00#23-F-N-00-00-00-00#23-F-N-00-00-00-00#23-F-N-00-00-00-00#23-F-N-00-00-00-00#23-F-N-00-00-00-00#23-F-N-00-00-00-00#23-F-N-00-00-00-00#23-F-N-00-00-00-00#23-F-N-00-00-00-00#23-F-N-00-00-00-00#15-B-N-00-00-00-00#
13-B-N-00-00-00-00#23-F-N-00-00-00-00#23-F-N-00-00-00-00#23-F-N-00-00-00-00#23-F-N-00-00-00-00#23-F-N-00-00-00-00#23-F-N-00-00-00-00#23-F-N-00-00-00-00#23-F-N-00-00-00-00#23-F-N-00-00-00-00#23-F-N-00-00-00-00#23-F-N-00-00-00-00#23-F-N-00-00-00-00#23-F-N-00-00-00-00#23-F-N-00-00-00-00#23-F-N-00-00-00-00#23-F-N-00-00-00-00#23-F-N-00-00-00-00#23-F-N-00-00-00-00#23-F-N-00-00-00-00#23-F-N-00-00-00-00#23-F-N-00-00-00-00#23-F-N-00-00-00-00#15-B-N-00-00-00-00#
13-B-N-00-00-00-00#23-F-N-00-00-00-00#23-F-N-00-00-00-00#23-F-N-00-00-00-00#23-F-N-00-00-00-00#23-F-N-00-00-00-00#23-F-N-00-00-00-00#23-F-N-00-00-00-00#23-F-N-00-00-00-00#23-F-N-00-00-00-00#23-F-N-00-00-00-00#23-F-N-00-00-00-00#23-F-N-00-00-00-00#23-F-N-00-00-00-00#23-F-N-00-00-00-00#23-F-N-00-00-00-00#23-F-N-00-00-00-00#23-F-N-00-00-00-00#23-F-N-00-00-00-00#23-F-N-00-00-00-00#23-F-N-00-00-00-00#23-F-N-00-00-00-00#23-F-N-00-00-00-00#15-B-N-00-00-00-00#
13-B-N-00-00-00-00#23-F-N-00-00-00-00#23-F-N-00-00-00-00#23-F-N-00-00-00-00#23-F-N-00-00-00-00#23-F-N-00-00-00-00#23-F-N-00-00-00-00#23-F-N-00-00-00-00#23-F-N-00-00-00-00#23-F-N-00-00-00-00#23-F-N-00-00-00-00#23-F-N-00-00-00-00#23-F-N-00-00-00-00#23-F-N-00-00-00-00#23-F-N-00-00-00-00#23-F-N-00-00-00-00#23-F-N-00-00-00-00#23-F-N-00-00-00-00#23-F-N-00-00-00-00#23-F-N-00-00-00-00#23-F-N-00-00-00-00#23-F-N-00-00-00-00#23-F-N-00-00-00-00#15-B-N-00-00-00-00#
13-B-N-00-00-00-00#23-F-N-00-00-00-00#23-F-N-00-00-00-00#23-F-N-00-00-00-00#23-F-N-00-00-00-00#23-F-N-00-00-00-00#23-F-N-00-00-00-00#23-F-N-00-00-00-00#23-F-N-00-00-00-00#23-F-N-00-00-00-00#23-F-N-00-00-00-00#23-F-N-00-00-00-00#23-F-N-00-00-00-00#23-F-N-00-00-00-00#23-F-N-00-00-00-00#23-F-N-00-00-00-00#23-F-N-00-00-00-00#23-F-N-00-00-00-00#23-F-N-00-00-00-00#23-F-N-00-00-00-00#23-F-N-00-00-00-00#23-F-N-00-00-00-00#23-F-N-00-00-00-00#15-B-N-00-00-00-00#
13-B-N-00-00-00-00#23-F-N-00-00-00-00#23-F-N-00-00-00-00#23-F-N-00-00-00-00#23-F-N-00-00-00-00#23-F-N-00-00-00-00#23-F-N-00-00-00-00#23-F-N-00-00-00-00#23-F-N-00-00-00-00#23-F-N-00-00-00-00#23-F-N-00-00-00-00#23-F-N-00-00-00-00#23-F-N-00-00-00-00#23-F-N-00-00-00-00#23-F-N-00-00-00-00#23-F-N-00-00-00-00#23-F-N-00-00-00-00#23-F-N-00-00-00-00#23-F-N-00-00-00-00#23-F-N-00-00-00-00#23-F-N-00-00-00-00#23-F-N-00-00-00-00#23-F-N-00-00-00-00#15-B-N-00-00-00-00#
13-B-N-00-00-00-00#23-F-N-00-00-00-00#23-F-N-00-00-00-00#23-F-N-00-00-00-00#23-F-N-00-00-00-00#23-F-N-00-00-00-00#23-F-N-00-00-00-00#23-F-N-00-00-00-00#23-F-N-00-00-00-00#23-F-N-00-00-00-00#23-F-N-00-00-00-00#23-F-N-00-00-00-00#23-F-N-00-00-00-00#23-F-N-00-00-00-00#23-F-N-00-00-00-00#23-F-N-00-00-00-00#23-F-N-00-00-00-00#23-F-N-00-00-00-00#23-F-N-00-00-00-00#23-F-N-00-00-00-00#23-F-N-00-00-00-00#23-F-N-00-00-00-00#23-F-N-00-00-00-00#15-B-N-00-00-00-00#
13-B-N-00-00-00-00#23-F-N-00-00-00-00#23-F-N-00-00-00-00#23-F-N-00-00-00-00#23-F-N-00-00-00-00#23-F-N-00-00-00-00#23-F-N-00-00-00-00#23-F-N-00-00-00-00#23-F-N-00-00-00-00#23-F-N-00-00-00-00#23-F-N-00-00-00-00#23-F-N-00-00-00-00#23-F-N-00-00-00-00#23-F-N-00-00-00-00#23-F-N-00-00-00-00#23-F-N-00-00-00-00#23-F-N-00-00-00-00#23-F-N-00-00-00-00#23-F-N-00-00-00-00#23-F-N-00-00-00-00#23-F-N-00-00-00-00#23-F-N-00-00-00-00#23-F-N-00-00-00-00#15-B-N-00-00-00-00#
13-B-N-00-00-00-00#23-F-N-00-00-00-00#23-F-N-00-00-00-00#23-F-N-00-00-00-00#23-F-N-00-00-00-00#23-F-N-00-00-00-00#23-F-N-00-00-00-00#23-F-N-00-00-00-00#23-F-N-00-00-00-00#23-F-N-00-00-00-00#23-F-N-00-00-00-00#23-F-N-00-00-00-00#23-F-N-00-00-00-00#23-F-N-00-00-00-00#23-F-N-00-00-00-00#23-F-N-00-00-00-00#23-F-N-00-00-00-00#23-F-N-00-00-00-00#23-F-N-00-00-00-00#23-F-N-00-00-00-00#23-F-N-00-00-00-00#23-F-N-00-00-00-00#23-F-N-00-00-00-00#15-B-N-00-00-00-00#
13-B-N-00-00-00-00#23-F-N-00-00-00-00#23-F-N-00-00-00-00#23-F-N-00-00-00-00#23-F-N-00-00-00-00#23-F-N-00-00-00-00#23-F-N-00-00-00-00#23-F-N-00-00-00-00#23-F-N-00-00-00-00#23-F-N-00-00-00-00#23-F-N-00-00-00-00#23-F-N-00-00-00-00#23-F-N-00-00-00-00#23-F-N-00-00-00-00#23-F-N-00-00-00-00#23-F-N-00-00-00-00#23-F-N-00-00-00-00#23-F-N-00-00-00-00#23-F-N-00-00-00-00#23-F-N-00-00-00-00#23-F-N-00-00-00-00#23-F-N-00-00-00-00#23-F-N-00-00-00-00#15-B-N-00-00-00-00#
13-B-N-00-00-00-00#23-F-N-00-00-00-00#23-F-N-00-00-00-00#23-F-N-00-00-00-00#23-F-N-00-00-00-00#23-F-N-00-00-00-00#23-F-N-00-00-00-00#23-F-N-00-00-00-00#23-F-N-00-00-00-00#23-F-N-00-00-00-00#23-F-N-00-00-00-00#23-F-N-00-00-00-00#23-F-N-00-00-00-00#23-F-N-00-00-00-00#23-F-N-00-00-00-00#23-F-N-00-00-00-00#23-F-N-00-00-00-00#23-F-N-00-00-00-00#23-F-N-00-00-00-00#23-F-N-00-00-00-00#23-F-N-00-00-00-00#23-F-N-00-00-00-00#23-F-N-00-00-00-00#15-B-N-00-00-00-00#
13-B-N-00-00-00-00#23-F-N-00-00-00-00#23-F-N-00-00-00-00#23-F-N-00-00-00-00#23-F-N-00-00-00-00#23-F-N-00-00-00-00#23-F-N-00-00-00-00#23-F-N-00-00-00-00#23-F-N-00-00-00-00#23-F-N-00-00-00-00#23-F-N-00-00-00-00#23-F-N-00-00-00-00#23-F-N-00-00-00-00#23-F-N-00-00-00-00#23-F-N-00-00-00-00#23-F-N-00-00-00-00#23-F-N-00-00-00-00#23-F-N-00-00-00-00#23-F-N-00-00-00-00#23-F-N-00-00-00-00#23-F-N-00-00-00-00#23-F-N-00-00-00-00#23-F-N-00-00-00-00#15-B-N-00-00-00-00#
13-B-N-00-00-00-00#23-F-N-00-00-00-00#23-F-N-00-00-00-00#23-F-N-00-00-00-00#23-F-N-00-00-00-00#23-F-N-00-00-00-00#23-F-N-00-00-00-00#23-F-N-00-00-00-00#23-F-N-00-00-00-00#23-F-N-00-00-00-00#23-F-N-00-00-00-00#23-F-N-00-00-00-00#23-F-N-00-00-00-00#23-F-N-00-00-00-00#23-F-N-00-00-00-00#23-F-N-00-00-00-00#23-F-N-00-00-00-00#23-F-N-00-00-00-00#23-F-N-00-00-00-00#23-F-N-00-00-00-00#23-F-N-00-00-00-00#23-F-N-00-00-00-00#23-F-N-00-00-00-00#15-B-N-00-00-00-00#
13-B-N-00-00-00-00#23-F-N-00-00-00-00#23-F-N-00-00-00-00#23-F-N-00-00-00-00#23-F-N-00-00-00-00#23-F-N-00-00-00-00#23-F-N-00-00-00-00#23-F-N-00-00-00-00#23-F-N-00-00-00-00#23-F-N-00-00-00-00#23-F-N-00-00-00-00#23-F-N-00-00-00-00#23-F-N-00-00-00-00#23-F-N-00-00-00-00#23-F-N-00-00-00-00#23-F-N-00-00-00-00#23-F-N-00-00-00-00#23-F-N-00-00-00-00#23-F-N-00-00-00-00#23-F-N-00-00-00-00#23-F-N-00-00-00-00#23-F-N-00-00-00-00#23-F-N-00-00-00-00#15-B-N-00-00-00-00#
13-B-N-00-00-00-00#23-F-N-00-00-00-00#23-F-N-00-00-00-00#23-F-N-00-00-00-00#23-F-N-00-00-00-00#23-F-N-00-00-00-00#23-F-N-00-00-00-00#23-F-N-00-00-00-00#23-F-N-00-00-00-00#23-F-N-00-00-00-00#23-F-N-00-00-00-00#23-F-N-00-00-00-00#23-F-N-00-00-00-00#23-F-N-00-00-00-00#23-F-N-00-00-00-00#23-F-N-00-00-00-00#23-F-N-00-00-00-00#23-F-N-00-00-00-00#23-F-N-00-00-00-00#23-F-N-00-00-00-00#23-F-N-00-00-00-00#23-F-N-00-00-00-00#23-F-N-00-00-00-00#15-B-N-00-00-00-00#
13-B-N-00-00-00-00#23-F-N-00-00-00-00#23-F-N-00-00-00-00#23-F-N-00-00-00-00#23-F-N-00-00-00-00#23-F-N-00-00-00-00#23-F-N-00-00-00-00#23-F-N-00-00-00-00#23-F-N-00-00-00-00#23-F-N-00-00-00-00#23-F-N-00-00-00-00#23-F-N-00-00-00-00#23-F-N-00-00-00-00#23-F-N-00-00-00-00#23-F-N-00-00-00-00#23-F-N-00-00-00-00#23-F-N-00-00-00-00#23-F-N-00-00-00-00#23-F-N-00-00-00-00#23-F-N-00-00-00-00#23-F-N-00-00-00-00#23-F-N-00-00-00-00#23-F-N-00-00-00-00#15-B-N-00-00-00-00#
13-B-N-00-00-00-00#23-F-N-00-00-00-00#23-F-N-00-00-00-00#23-F-N-00-00-00-00#23-F-N-00-00-00-00#23-F-N-00-00-00-00#23-F-N-00-00-00-00#23-F-N-00-00-00-00#23-F-N-00-00-00-00#23-F-N-00-00-00-00#23-F-N-00-00-00-00#23-F-N-00-00-00-00#23-F-N-00-00-00-00#23-F-N-00-00-00-00#23-F-N-00-00-00-00#23-F-N-00-00-00-00#23-F-N-00-00-00-00#23-F-N-00-00-00-00#23-F-N-00-00-00-00#23-F-N-00-00-00-00#23-F-N-00-00-00-00#23-F-N-00-00-00-00#23-F-N-00-00-00-00#15-B-N-00-00-00-00#
13-B-N-00-00-00-00#23-F-N-00-00-00-00#23-F-N-00-00-00-00#23-F-N-00-00-00-00#23-F-N-00-00-00-00#23-F-N-00-00-00-00#23-F-N-00-00-00-00#23-F-N-00-00-00-00#23-F-N-00-00-00-00#23-F-N-00-00-00-00#23-F-N-00-00-00-00#23-F-N-00-00-00-00#23-F-N-00-00-00-00#23-F-N-00-00-00-00#23-F-N-00-00-00-00#23-F-N-00-00-00-00#23-F-N-00-00-00-00#23-F-N-00-00-00-00#23-F-N-00-00-00-00#23-F-N-00-00-00-00#23-F-N-00-00-00-00#23-F-N-00-00-00-00#23-F-N-00-00-00-00#15-B-N-00-00-00-00#
13-B-N-00-00-00-00#23-F-N-00-00-00-00#23-F-N-00-00-00-00#23-F-N-00-00-00-00#23-F-N-00-00-00-00#23-F-N-00-00-00-00#23-F-N-00-00-00-00#23-F-N-00-00-00-00#23-F-N-00-00-00-00#23-F-N-00-00-00-00#23-F-N-00-00-00-00#23-F-N-00-00-00-00#23-F-N-00-00-00-00#23-F-N-00-00-00-00#23-F-N-00-00-00-00#23-F-N-00-00-00-00#23-F-N-00-00-00-00#23-F-N-00-00-00-00#23-F-N-00-00-00-00#23-F-N-00-00-00-00#23-F-N-00-00-00-00#23-F-N-00-00-00-00#23-F-N-00-00-00-00#15-B-N-00-00-00-00#
25-B-N-00-00-00-00#26-B-N-00-00-00-00#26-B-N-00-00-00-00#26-B-N-00-00-00-00#26-B-N-00-00-00-00#26-B-N-00-00-00-00#26-B-N-00-00-00-00#26-B-N-00-00-00-00#26-B-N-00-00-00-00#26-B-N-00-00-00-00#26-B-N-00-00-00-00#26-B-N-00-00-00-00#26-B-N-00-00-00-00#26-B-N-00-00-00-00#26-B-N-00-00-00-00#26-B-N-00-00-00-00#26-B-N-00-00-00-00#26-B-N-00-00-00-00#26-B-N-00-00-00-00#26-B-N-00-00-00-00#26-B-N-00-00-00-00#26-B-N-00-00-00-00#26-B-N-00-00-00-00#27-B-N-00-00-00-00#
tileSetB.png#16#16#64#64#0#
24#24#64#64
00-F-N-00-00-00-00#00-F-N-00-00-00-00#00-F-N-00-00-00-00#00-F-N-00-00-00-00#00-F-N-00-00-00-00#00-F-N-00-00-00-00#00-F-N-00-00-00-00#00-F-N-00-00-00-00#00-F-N-00-00-00-00#00-F-N-00-00-00-00#00-F-N-00-00-00-00#00-F-N-00-00-00-00#00-F-N-00-00-00-00#00-F-N-00-00-00-00#00-F-N-00-00-00-00#00-F-N-00-00-00-00#00-F-N-00-00-00-00#00-F-N-00-00-00-00#00-F-N-00-00-00-00#00-F-N-00-00-00-00#00-F-N-00-00-00-00#00-F-N-00-00-00-00#00-F-N-00-00-00-00#00-F-N-00-00-00-00#
00-F-N-00-00-00-00#00-F-N-00-00-00-00#00-F-N-00-00-00-00#00-F-N-00-00-00-00#00-F-N-00-00-00-00#00-F-N-00-00-00-00#00-F-N-00-00-00-00#00-F-N-00-00-00-00#00-F-N-00-00-00-00#00-F-N-00-00-00-00#00-F-N-00-00-00-00#00-F-N-00-00-00-00#00-F-N-00-00-00-00#00-F-N-00-00-00-00#00-F-N-00-00-00-00#00-F-N-00-00-00-00#00-F-N-00-00-00-00#00-F-N-00-00-00-00#00-F-N-00-00-00-00#00-F-N-00-00-00-00#00-F-N-00-00-00-00#00-F-N-00-00-00-00#00-F-N-00-00-00-00#00-F-N-00-00-00-00#
00-F-N-00-00-00-00#00-F-N-00-00-00-00#00-F-N-00-00-00-00#00-F-N-00-00-00-00#00-F-N-00-00-00-00#00-F-N-00-00-00-00#00-F-N-00-00-00-00#00-F-N-00-00-00-00#00-F-N-00-00-00-00#00-F-N-00-00-00-00#00-F-N-00-00-00-00#00-F-N-00-00-00-00#00-F-N-00-00-00-00#00-F-N-00-00-00-00#00-F-N-00-00-00-00#00-F-N-00-00-00-00#00-F-N-00-00-00-00#00-F-N-00-00-00-00#00-F-N-00-00-00-00#00-F-N-00-00-00-00#00-F-N-00-00-00-00#00-F-N-00-00-00-00#00-F-N-00-00-00-00#00-F-N-00-00-00-00#
00-F-N-00-00-00-00#00-F-N-00-00-00-00#00-F-N-00-00-00-00#00-F-N-00-00-00-00#00-F-N-00-00-00-00#00-F-N-00-00-00-00#00-F-N-00-00-00-00#00-F-N-00-00-00-00#00-F-N-00-00-00-00#00-F-N-00-00-00-00#00-F-N-00-00-00-00#00-F-N-00-00-00-00#00-F-N-00-00-00-00#00-F-N-00-00-00-00#00-F-N-00-00-00-00#00-F-N-00-00-00-00#00-F-N-00-00-00-00#00-F-N-00-00-00-00#00-F-N-00-00-00-00#00-F-N-00-00-00-00#00-F-N-00-00-00-00#00-F-N-00-00-00-00#00-F-N-00-00-00-00#00-F-N-00-00-00-00#
00-F-N-00-00-00-00#00-F-N-00-00-00-00#00-F-N-00-00-00-00#00-F-N-00-00-00-00#00-F-N-00-00-00-00#00-F-N-00-00-00-00#00-F-N-00-00-00-00#00-F-N-00-00-00-00#00-F-N-00-00-00-00#00-F-N-00-00-00-00#00-F-N-00-00-00-00#00-F-N-00-00-00-00#00-F-N-00-00-00-00#00-F-N-00-00-00-00#00-F-N-00-00-00-00#00-F-N-00-00-00-00#00-F-N-00-00-00-00#00-F-N-00-00-00-00#00-F-N-00-00-00-00#00-F-N-00-00-00-00#00-F-N-00-00-00-00#00-F-N-00-00-00-00#00-F-N-00-00-00-00#00-F-N-00-00-00-00#
00-F-N-00-00-00-00#00-F-N-00-00-00-00#00-F-N-00-00-00-00#00-F-N-00-00-00-00#00-F-N-00-00-00-00#00-F-N-00-00-00-00#00-F-N-00-00-00-00#00-F-N-00-00-00-00#71-B-N-00-00-00-00#72-B-N-00-00-00-00#00-F-N-00-00-00-00#00-F-N-00-00-00-00#00-F-N-00-00-00-00#00-F-N-00-00-00-00#00-F-N-00-00-00-00#232-T-I-00-00-00-00#232-T-I-00-00-00-00#232-T-I-00-00-00-00#00-F-N-00-00-00-00#00-F-N-00-00-00-00#00-F-N-00-00-00-00#00-F-N-00-00-00-00#00-F-N-00-00-00-00#00-F-N-00-00-00-00#
00-F-N-00-00-00-00#00-F-N-00-00-00-00#00-F-N-00-00-00-00#00-F-N-00-00-00-00#00-F-N-00-00-00-00#00-F-N-00-00-00-00#00-F-N-00-00-00-00#00-F-N-00-00-00-00#87-B-N-00-00-00-00#88-B-N-00-00-00-00#00-F-N-00-00-00-00#00-F-N-00-00-00-00#00-F-N-00-00-00-00#00-F-N-00-00-00-00#00-F-N-00-00-00-00#232-T-I-00-00-00-00#232-T-I-00-00-00-00#232-T-I-00-00-00-00#00-F-N-00-00-00-00#00-F-N-00-00-00-00#00-F-N-00-00-00-00#00-F-N-00-00-00-00#00-F-N-00-00-00-00#00-F-N-00-00-00-00#
00-F-N-00-00-00-00#00-F-N-00-00-00-00#00-F-N-00-00-00-00#00-F-N-00-00-00-00#00-F-N-00-00-00-00#00-F-N-00-00-00-00#00-F-N-00-00-00-00#00-F-N-00-00-00-00#00-F-N-00-00-00-00#00-F-N-00-00-00-00#00-F-N-00-00-00-00#00-F-N-00-00-00-00#00-F-N-00-00-00-00#00-F-N-00-00-00-00#00-F-N-00-00-00-00#232-T-I-00-00-00-00#232-T-I-00-00-00-00#232-T-I-00-00-00-00#00-F-N-00-00-00-00#00-F-N-00-00-00-00#00-F-N-00-00-00-00#00-F-N-00-00-00-00#00-F-N-00-00-00-00#00-F-N-00-00-00-00#
00-F-N-00-00-00-00#00-F-N-00-00-00-00#00-F-N-00-00-00-00#00-F-N-00-00-00-00#00-F-N-00-00-00-00#00-F-N-00-00-00-00#00-F-N-00-00-00-00#00-F-N-00-00-00-00#00-F-N-00-00-00-00#00-F-N-00-00-00-00#00-F-N-00-00-00-00#00-F-N-00-00-00-00#00-F-N-00-00-00-00#00-F-N-00-00-00-00#00-F-N-00-00-00-00#00-F-N-00-00-00-00#00-F-N-00-00-00-00#00-F-N-00-00-00-00#00-F-N-00-00-00-00#00-F-N-00-00-00-00#00-F-N-00-00-00-00#00-F-N-00-00-00-00#00-F-N-00-00-00-00#00-F-N-00-00-00-00#
00-F-N-00-00-00-00#00-F-N-00-00-00-00#00-F-N-00-00-00-00#00-F-N-00-00-00-00#00-F-N-00-00-00-00#00-F-N-00-00-00-00#00-F-N-00-00-00-00#00-F-N-00-00-00-00#00-F-N-00-00-00-00#00-F-N-00-00-00-00#00-F-N-00-00-00-00#00-F-N-00-00-00-00#00-F-N-00-00-00-00#00-F-N-00-00-00-00#00-F-N-00-00-00-00#00-F-N-00-00-00-00#00-F-N-00-00-00-00#00-F-N-00-00-00-00#00-F-N-00-00-00-00#00-F-N-00-00-00-00#00-F-N-00-00-00-00#00-F-N-00-00-00-00#00-F-N-00-00-00-00#00-F-N-00-00-00-00#
00-F-N-00-00-00-00#00-F-N-00-00-00-00#174-B-N-00-00-00-00#190-B-I-175-00-00-00#191-B-I-175-00-00-00#192-B-I-175-00-00-00#176-B-N-00-00-00-00#00-F-N-00-00-00-00#00-F-N-00-00-00-00#00-F-N-00-00-00-00#00-F-N-00-00-00-00#00-F-N-00-00-00-00#00-F-N-00-00-00-00#00-F-N-00-00-00-00#00-F-N-00-00-00-00#00-F-N-00-00-00-00#00-F-N-00-00-00-00#00-F-N-00-00-00-00#00-F-N-00-00-00-00#00-F-N-00-00-00-00#00-F-N-00-00-00-00#00-F-N-00-00-00-00#00-F-N-00-00-00-00#00-F-N-00-00-00-00#
00-F-N-00-00-00-00#00-F-N-00-00-00-00#00-F-N-00-00-00-00#00-F-N-00-00-00-00#00-F-N-00-00-00-00#00-F-N-00-00-00-00#00-F-N-00-00-00-00#00-F-N-00-00-00-00#00-F-N-00-00-00-00#00-F-N-00-00-00-00#00-F-N-00-00-00-00#43-B-I-42-00-00-00#00-F-N-00-00-00-00#00-F-N-00-00-00-00#00-F-N-00-00-00-00#00-F-N-00-00-00-00#00-F-N-00-00-00-00#00-F-N-00-00-00-00#00-F-N-00-00-00-00#00-F-N-00-00-00-00#00-F-N-00-00-00-00#00-F-N-00-00-00-00#00-F-N-00-00-00-00#00-F-N-00-00-00-00#
00-F-N-00-00-00-00#00-F-N-00-00-00-00#00-F-N-00-00-00-00#00-F-N-00-00-00-00#00-F-N-00-00-00-00#00-F-N-00-00-00-00#00-F-N-00-00-00-00#00-F-N-00-00-00-00#00-F-N-00-00-00-00#00-F-N-00-00-00-00#00-F-N-00-00-00-00#00-F-N-00-00-00-00#00-F-N-00-00-00-00#00-F-N-00-00-00-00#00-F-N-00-00-00-00#00-F-N-00-00-00-00#00-F-N-00-00-00-00#00-F-N-00-00-00-00#00-F-N-00-00-00-00#00-F-N-00-00-00-00#00-F-N-00-00-00-00#00-F-N-00-00-00-00#00-F-N-00-00-00-00#00-F-N-00-00-00-00#
00-F-N-00-00-00-00#00-F-N-00-00-00-00#00-F-N-00-00-00-00#00-F-N-00-00-00-00#00-F-N-00-00-00-00#00-F-N-00-00-00-00#00-F-N-00-00-00-00#00-F-N-00-00-00-00#00-F-N-00-00-00-00#00-F-N-00-00-00-00#00-F-N-00-00-00-00#00-F-N-00-00-00-00#00-F-N-00-00-00-00#00-F-N-00-00-00-00#00-F-N-00-00-00-00#00-F-N-00-00-00-00#00-F-N-00-00-00-00#00-F-N-00-00-00-00#00-F-N-00-00-00-00#00-F-N-00-00-00-00#00-F-N-00-00-00-00#00-F-N-00-00-00-00#00-F-N-00-00-00-00#00-F-N-00-00-00-00#
00-F-N-00-00-00-00#00-F-N-00-00-00-00#00-F-N-00-00-00-00#00-F-N-00-00-00-00#00-F-N-00-00-00-00#00-F-N-00-00-00-00#00-F-N-00-00-00-00#00-F-N-00-00-00-00#00-F-N-00-00-00-00#00-F-N-00-00-00-00#00-F-N-00-00-00-00#00-F-N-00-00-00-00#00-F-N-00-00-00-00#00-F-N-00-00-00-00#00-F-N-00-00-00-00#00-F-N-00-00-00-00#00-F-N-00-00-00-00#00-F-N-00-00-00-00#00-F-N-00-00-00-00#00-F-N-00-00-00-00#00-F-N-00-00-00-00#00-F-N-00-00-00-00#00-F-N-00-00-00-00#00-F-N-00-00-00-00#
00-F-N-00-00-00-00#00-F-N-00-00-00-00#00-F-N-00-00-00-00#00-F-N-00-00-00-00#00-F-N-00-00-00-00#00-F-N-00-00-00-00#00-F-N-00-00-00-00#00-F-N-00-00-00-00#00-F-N-00-00-00-00#00-F-N-00-00-00-00#00-F-N-00-00-00-00#00-F-N-00-00-00-00#00-F-N-00-00-00-00#00-F-N-00-00-00-00#00-F-N-00-00-00-00#00-F-N-00-00-00-00#00-F-N-00-00-00-00#00-F-N-00-00-00-00#00-F-N-00-00-00-00#00-F-N-00-00-00-00#00-F-N-00-00-00-00#00-F-N-00-00-00-00#00-F-N-00-00-00-00#00-F-N-00-00-00-00#
00-F-N-00-00-00-00#00-F-N-00-00-00-00#82-B-K-00-00-00-00#00-F-N-00-00-00-00#00-F-N-00-00-00-00#00-F-N-00-00-00-00#00-F-N-00-00-00-00#00-F-N-00-00-00-00#00-F-N-00-00-00-00#00-F-N-00-00-00-00#00-F-N-00-00-00-00#00-F-N-00-00-00-00#00-F-N-00-00-00-00#00-F-N-00-00-00-00#00-F-N-00-00-00-00#00-F-N-00-00-00-00#00-F-N-00-00-00-00#00-F-N-00-00-00-00#00-F-N-00-00-00-00#00-F-N-00-00-00-00#00-F-N-00-00-00-00#00-F-N-00-00-00-00#00-F-N-00-00-00-00#00-F-N-00-00-00-00#
00-F-N-00-00-00-00#00-F-N-00-00-00-00#00-F-N-00-00-00-00#00-F-N-00-00-00-00#00-F-N-00-00-00-00#00-F-N-00-00-00-00#00-F-N-00-00-00-00#00-F-N-00-00-00-00#00-F-N-00-00-00-00#00-F-N-00-00-00-00#00-F-N-00-00-00-00#00-F-N-00-00-00-00#00-F-N-00-00-00-00#00-F-N-00-00-00-00#00-F-N-00-00-00-00#00-F-N-00-00-00-00#00-F-N-00-00-00-00#00-F-N-00-00-00-00#00-F-N-00-00-00-00#00-F-N-00-00-00-00#00-F-N-00-00-00-00#00-F-N-00-00-00-00#00-F-N-00-00-00-00#00-F-N-00-00-00-00#
00-F-N-00-00-00-00#00-F-N-00-00-00-00#00-F-N-00-00-00-00#00-F-N-00-00-00-00#00-F-N-00-00-00-00#00-F-N-00-00-00-00#00-F-N-00-00-00-00#00-F-N-00-00-00-00#00-F-N-00-00-00-00#00-F-N-00-00-00-00#00-F-N-00-00-00-00#00-F-N-00-00-00-00#00-F-N-00-00-00-00#00-F-N-00-00-00-00#00-F-N-00-00-00-00#00-F-N-00-00-00-00#00-F-N-00-00-00-00#00-F-N-00-00-00-00#00-F-N-00-00-00-00#00-F-N-00-00-00-00#00-F-N-00-00-00-00#00-F-N-00-00-00-00#00-F-N-00-00-00-00#00-F-N-00-00-00-00#
00-F-N-00-00-00-00#00-F-N-00-00-00-00#00-F-N-00-00-00-00#00-F-N-00-00-00-00#00-F-N-00-00-00-00#00-F-N-00-00-00-00#00-F-N-00-00-00-00#00-F-N-00-00-00-00#00-F-N-00-00-00-00#00-F-N-00-00-00-00#00-F-N-00-00-00-00#00-F-N-00-00-00-00#00-F-N-00-00-00-00#00-F-N-00-00-00-00#00-F-N-00-00-00-00#00-F-N-00-00-00-00#00-F-N-00-00-00-00#00-F-N-00-00-00-00#00-F-N-00-00-00-00#00-F-N-00-00-00-00#00-F-N-00-00-00-00#00-F-N-00-00-00-00#00-F-N-00-00-00-00#00-F-N-00-00-00-00#
00-F-N-00-00-00-00#00-F-N-00-00-00-00#00-F-N-00-00-00-00#00-F-N-00-00-00-00#00-F-N-00-00-00-00#00-F-N-00-00-00-00#00-F-N-00-00-00-00#00-F-N-00-00-00-00#00-F-N-00-00-00-00#00-F-N-00-00-00-00#00-F-N-00-00-00-00#00-F-N-00-00-00-00#00-F-N-00-00-00-00#00-F-N-00-00-00-00#00-F-N-00-00-00-00#00-F-N-00-00-00-00#00-F-N-00-00-00-00#00-F-N-00-00-00-00#00-F-N-00-00-00-00#00-F-N-00-00-00-00#00-F-N-00-00-00-00#00-F-N-00-00-00-00#00-F-N-00-00-00-00#00-F-N-00-00-00-00#
00-F-N-00-00-00-00#00-F-N-00-00-00-00#00-F-N-00-00-00-00#00-F-N-00-00-00-00#00-F-N-00-00-00-00#00-F-N-00-00-00-00#00-F-N-00-00-00-00#00-F-N-00-00-00-00#00-F-N-00-00-00-00#00-F-N-00-00-00-00#00-F-N-00-00-00-00#00-F-N-00-00-00-00#00-F-N-00-00-00-00#00-F-N-00-00-00-00#00-F-N-00-00-00-00#00-F-N-00-00-00-00#00-F-N-00-00-00-00#00-F-N-00-00-00-00#00-F-N-00-00-00-00#00-F-N-00-00-00-00#00-F-N-00-00-00-00#00-F-N-00-00-00-00#00-F-N-00-00-00-00#00-F-N-00-00-00-00#
00-F-N-00-00-00-00#00-F-N-00-00-00-00#00-F-N-00-00-00-00#00-F-N-00-00-00-00#00-F-N-00-00-00-00#00-F-N-00-00-00-00#00-F-N-00-00-00-00#00-F-N-00-00-00-00#00-F-N-00-00-00-00#00-F-N-00-00-00-00#00-F-N-00-00-00-00#00-F-N-00-00-00-00#00-F-N-00-00-00-00#00-F-N-00-00-00-00#00-F-N-00-00-00-00#00-F-N-00-00-00-00#00-F-N-00-00-00-00#00-F-N-00-00-00-00#00-F-N-00-00-00-00#00-F-N-00-00-00-00#00-F-N-00-00-00-00#00-F-N-00-00-00-00#00-F-N-00-00-00-00#00-F-N-00-00-00-00#
00-F-N-00-00-00-00#00-F-N-00-00-00-00#00-F-N-00-00-00-00#00-F-N-00-00-00-00#00-F-N-00-00-00-00#00-F-N-00-00-00-00#00-F-N-00-00-00-00#00-F-N-00-00-00-00#00-F-N-00-00-00-00#00-F-N-00-00-00-00#00-F-N-00-00-00-00#00-F-N-00-00-00-00#00-F-N-00-00-00-00#00-F-N-00-00-00-00#00-F-N-00-00-00-00#00-F-N-00-00-00-00#00-F-N-00-00-00-00#00-F-N-00-00-00-00#00-F-N-00-00-00-00#00-F-N-00-00-00-00#00-F-N-00-00-00-00#00-F-N-00-00-00-00#00-F-N-00-00-00-00#00-F-N-00-00-00-00#
