1
lab tileset finished transparent.png#30#18#32#32#0#
60#24#64#64#
230-B-N-00-00-00-00#211-B-N-00-00-00-00#212-B-N-00-00-00-00#213-B-N-00-00-00-00#214-B-N-00-00-00-00#215-B-N-00-00-00-00#216-B-N-00-00-00-00#217-B-N-00-00-00-00#218-B-N-00-00-00-00#219-B-N-00-00-00-00#220-B-N-00-00-00-00#221-B-N-00-00-00-00#222-B-N-00-00-00-00#223-B-N-00-00-00-00#211-B-N-00-00-00-00#212-B-N-00-00-00-00#213-B-N-00-00-00-00#214-B-N-00-00-00-00#215-B-N-00-00-00-00#216-B-N-00-00-00-00#217-B-N-00-00-00-00#218-B-N-00-00-00-00#219-B-N-00-00-00-00#220-B-N-00-00-00-00#221-B-N-00-00-00-00#222-B-N-00-00-00-00#223-B-N-00-00-00-00#211-B-N-00-00-00-00#212-B-N-00-00-00-00#213-B-N-00-00-00-00#214-B-N-00-00-00-00#110-B-N-00-00-00-00#211-B-N-00-00-00-00#212-B-N-00-00-00-00#213-B-N-00-00-00-00#214-B-N-00-00-00-00#215-B-N-00-00-00-00#216-B-N-00-00-00-00#217-B-N-00-00-00-00#218-B-N-00-00-00-00#219-B-N-00-00-00-00#220-B-N-00-00-00-00#221-B-N-00-00-00-00#222-B-N-00-00-00-00#223-B-N-00-00-00-00#211-B-N-00-00-00-00#212-B-N-00-00-00-00#213-B-N-00-00-00-00#214-B-N-00-00-00-00#215-B-N-00-00-00-00#216-B-N-00-00-00-00#217-B-N-00-00-00-00#218-B-N-00-00-00-00#219-B-N-00-00-00-00#125-B-N-00-00-00-00#467-F-A-00-00-00-00#468-F-A-00-00-00-00#123-B-N-00-00-00-00#124-B-N-00-00-00-00#350-B-N-00-00-00-00#
416-B-N-00-00-00-00#499-F-N-00-00-00-00#466-F-N-00-00-00-00#467-F-N-00-00-00-00#468-F-N-00-00-00-00#469-F-N-00-00-00-00#496-F-N-00-00-00-00#497-F-N-00-00-00-00#498-F-N-00-00-00-00#499-F-N-00-00-00-00#466-F-N-00-00-00-00#467-F-N-00-00-00-00#468-F-N-00-00-00-00#469-F-N-00-00-00-00#496-F-N-00-00-00-00#497-F-N-00-00-00-00#498-F-N-00-00-00-00#499-F-N-00-00-00-00#466-F-N-00-00-00-00#467-F-N-00-00-00-00#468-F-N-00-00-00-00#469-F-N-00-00-00-00#496-F-N-00-00-00-00#497-F-N-00-00-00-00#498-F-N-00-00-00-00#499-F-N-00-00-00-00#466-F-N-00-00-00-00#467-F-N-00-00-00-00#468-F-N-00-00-00-00#469-F-N-00-00-00-00#496-F-N-00-00-00-00#450-B-N-00-00-00-00#498-F-N-00-00-00-00#499-F-N-00-00-00-00#466-F-N-00-00-00-00#467-F-N-00-00-00-00#468-F-N-00-00-00-00#469-F-N-00-00-00-00#496-F-N-00-00-00-00#497-F-N-00-00-00-00#498-F-N-00-00-00-00#499-F-N-00-00-00-00#466-F-N-00-00-00-00#467-F-N-00-00-00-00#468-F-N-00-00-00-00#469-F-N-00-00-00-00#498-F-N-00-00-00-00#499-F-N-00-00-00-00#466-F-N-00-00-00-00#467-F-N-00-00-00-00#468-F-N-00-00-00-00#469-F-N-00-00-00-00#496-F-N-00-00-00-00#497-F-N-00-00-00-00#498-F-N-00-00-00-00#499-F-N-00-00-00-00#466-F-N-00-00-00-00#467-F-N-00-00-00-00#468-F-N-00-00-00-00#418-B-N-00-00-00-00#
446-B-N-00-00-00-00#497-F-N-00-00-00-00#498-F-N-00-00-00-00#499-F-N-00-00-00-00#466-F-N-00-00-00-00#467-F-N-00-00-00-00#468-F-N-00-00-00-00#469-F-N-00-00-00-00#496-F-N-00-00-00-00#497-F-N-00-00-00-00#498-F-N-00-00-00-00#499-F-N-00-00-00-00#466-F-N-00-00-00-00#467-F-N-00-00-00-00#468-F-N-00-00-00-00#469-F-N-00-00-00-00#496-F-N-00-00-00-00#497-F-N-00-00-00-00#498-F-N-00-00-00-00#499-F-N-00-00-00-00#466-F-N-00-00-00-00#467-F-N-00-00-00-00#468-F-N-00-00-00-00#469-F-N-00-00-00-00#496-F-N-00-00-00-00#497-F-N-00-00-00-00#498-F-N-00-00-00-00#499-F-N-00-00-00-00#466-F-N-00-00-00-00#467-F-N-00-00-00-00#468-F-N-00-00-00-00#480-B-N-00-00-00-00#496-F-N-00-00-00-00#497-F-N-00-00-00-00#498-F-N-00-00-00-00#499-F-N-00-00-00-00#466-F-N-00-00-00-00#467-F-N-00-00-00-00#468-F-N-00-00-00-00#469-F-N-00-00-00-00#496-F-N-00-00-00-00#497-F-N-00-00-00-00#498-F-N-00-00-00-00#499-F-N-00-00-00-00#466-F-N-00-00-00-00#467-F-N-00-00-00-00#496-F-N-00-00-00-00#497-F-N-00-00-00-00#498-F-N-00-00-00-00#499-F-N-00-00-00-00#466-F-N-00-00-00-00#467-F-N-00-00-00-00#468-F-N-00-00-00-00#469-F-N-00-00-00-00#496-F-N-00-00-00-00#497-F-N-00-00-00-00#498-F-N-00-00-00-00#499-F-N-00-00-00-00#466-F-N-00-00-00-00#448-B-N-00-00-00-00#
476-B-N-00-00-00-00#469-F-N-00-00-00-00#496-F-N-00-00-00-00#497-F-N-00-00-00-00#498-F-N-00-00-00-00#499-F-N-00-00-00-00#466-F-N-00-00-00-00#467-F-N-00-00-00-00#468-F-N-00-00-00-00#469-F-N-00-00-00-00#496-F-N-00-00-00-00#497-F-N-00-00-00-00#498-F-N-00-00-00-00#499-F-N-00-00-00-00#466-F-N-00-00-00-00#467-F-N-00-00-00-00#468-F-N-00-00-00-00#469-F-N-00-00-00-00#496-F-N-00-00-00-00#497-F-N-00-00-00-00#498-F-N-00-00-00-00#499-F-N-00-00-00-00#466-F-N-00-00-00-00#467-F-N-00-00-00-00#468-F-N-00-00-00-00#469-F-N-00-00-00-00#496-F-N-00-00-00-00#497-F-N-00-00-00-00#498-F-N-00-00-00-00#499-F-N-00-00-00-00#466-F-N-00-00-00-00#510-B-N-00-00-00-00#468-F-N-00-00-00-00#469-F-N-00-00-00-00#496-F-N-00-00-00-00#497-F-N-00-00-00-00#498-F-N-00-00-00-00#499-F-N-00-00-00-00#466-F-N-00-00-00-00#467-F-N-00-00-00-00#468-F-N-00-00-00-00#469-F-N-00-00-00-00#496-F-N-00-00-00-00#497-F-N-00-00-00-00#498-F-N-00-00-00-00#499-F-N-00-00-00-00#468-F-N-00-00-00-00#469-F-N-00-00-00-00#496-F-N-00-00-00-00#497-F-N-00-00-00-00#498-F-N-00-00-00-00#499-F-N-00-00-00-00#466-F-N-00-00-00-00#467-F-N-00-00-00-00#471-B-N-00-00-00-00#472-B-N-00-00-00-00#473-B-N-00-00-00-00#474-B-N-00-00-00-00#498-F-N-00-00-00-00#478-B-N-00-00-00-00#
506-B-N-00-00-00-00#467-F-N-00-00-00-00#468-F-N-00-00-00-00#469-F-N-00-00-00-00#496-F-N-00-00-00-00#497-F-N-00-00-00-00#498-F-N-00-00-00-00#499-F-N-00-00-00-00#466-F-N-00-00-00-00#467-F-N-00-00-00-00#468-F-N-00-00-00-00#469-F-N-00-00-00-00#496-F-N-00-00-00-00#497-F-N-00-00-00-00#498-F-N-00-00-00-00#499-F-N-00-00-00-00#466-F-N-00-00-00-00#467-F-N-00-00-00-00#468-F-N-00-00-00-00#469-F-N-00-00-00-00#496-F-N-00-00-00-00#497-F-N-00-00-00-00#498-F-N-00-00-00-00#499-F-N-00-00-00-00#466-F-N-00-00-00-00#467-F-N-00-00-00-00#468-F-N-00-00-00-00#469-F-N-00-00-00-00#496-F-N-00-00-00-00#497-F-N-00-00-00-00#498-F-N-00-00-00-00#450-B-N-00-00-00-00#466-F-N-00-00-00-00#467-F-N-00-00-00-00#468-F-N-00-00-00-00#469-F-N-00-00-00-00#496-F-N-00-00-00-00#497-F-N-00-00-00-00#498-F-N-00-00-00-00#499-F-N-00-00-00-00#466-F-N-00-00-00-00#467-F-N-00-00-00-00#468-F-N-00-00-00-00#469-F-N-00-00-00-00#496-F-N-00-00-00-00#497-F-N-00-00-00-00#466-F-N-00-00-00-00#467-F-N-00-00-00-00#468-F-N-00-00-00-00#469-F-N-00-00-00-00#496-F-N-00-00-00-00#497-F-N-00-00-00-00#498-F-N-00-00-00-00#499-F-N-00-00-00-00#466-F-N-00-00-00-00#467-F-N-00-00-00-00#468-F-N-00-00-00-00#469-F-N-00-00-00-00#496-F-N-00-00-00-00#508-B-N-00-00-00-00#
536-B-N-00-00-00-00#499-F-N-00-00-00-00#466-F-N-00-00-00-00#467-F-N-00-00-00-00#468-F-N-00-00-00-00#469-F-N-00-00-00-00#496-F-N-00-00-00-00#497-F-N-00-00-00-00#498-F-N-00-00-00-00#499-F-N-00-00-00-00#466-F-N-00-00-00-00#467-F-N-00-00-00-00#468-F-N-00-00-00-00#469-F-N-00-00-00-00#496-F-N-00-00-00-00#497-F-N-00-00-00-00#498-F-N-00-00-00-00#499-F-N-00-00-00-00#466-F-N-00-00-00-00#467-F-N-00-00-00-00#468-F-N-00-00-00-00#469-F-N-00-00-00-00#496-F-N-00-00-00-00#497-F-N-00-00-00-00#498-F-N-00-00-00-00#499-F-N-00-00-00-00#466-F-N-00-00-00-00#467-F-N-00-00-00-00#468-F-N-00-00-00-00#469-F-N-00-00-00-00#496-F-N-00-00-00-00#480-B-N-00-00-00-00#498-F-N-00-00-00-00#499-F-N-00-00-00-00#466-F-N-00-00-00-00#467-F-N-00-00-00-00#468-F-N-00-00-00-00#469-F-N-00-00-00-00#496-F-N-00-00-00-00#497-F-N-00-00-00-00#498-F-N-00-00-00-00#499-F-N-00-00-00-00#466-F-N-00-00-00-00#467-F-N-00-00-00-00#468-F-N-00-00-00-00#469-F-N-00-00-00-00#498-F-N-00-00-00-00#499-F-N-00-00-00-00#466-F-N-00-00-00-00#467-F-N-00-00-00-00#468-F-N-00-00-00-00#469-F-N-00-00-00-00#496-F-N-00-00-00-00#497-F-N-00-00-00-00#498-F-N-00-00-00-00#499-F-N-00-00-00-00#466-F-N-00-00-00-00#467-F-N-00-00-00-00#468-F-N-00-00-00-00#538-B-N-00-00-00-00#
416-B-N-00-00-00-00#497-F-N-00-00-00-00#498-F-N-00-00-00-00#499-F-N-00-00-00-00#466-F-N-00-00-00-00#467-F-N-00-00-00-00#468-F-N-00-00-00-00#469-F-N-00-00-00-00#496-F-N-00-00-00-00#497-F-N-00-00-00-00#498-F-N-00-00-00-00#499-F-N-00-00-00-00#466-F-N-00-00-00-00#467-F-N-00-00-00-00#468-F-N-00-00-00-00#469-F-N-00-00-00-00#496-F-N-00-00-00-00#497-F-N-00-00-00-00#498-F-N-00-00-00-00#499-F-N-00-00-00-00#466-F-N-00-00-00-00#467-F-N-00-00-00-00#468-F-N-00-00-00-00#469-F-N-00-00-00-00#496-F-N-00-00-00-00#497-F-N-00-00-00-00#498-F-N-00-00-00-00#499-F-N-00-00-00-00#466-F-N-00-00-00-00#467-F-N-00-00-00-00#468-F-N-00-00-00-00#510-B-N-00-00-00-00#496-F-N-00-00-00-00#497-F-N-00-00-00-00#498-F-N-00-00-00-00#499-F-N-00-00-00-00#466-F-N-00-00-00-00#467-F-N-00-00-00-00#468-F-N-00-00-00-00#469-F-N-00-00-00-00#496-F-N-00-00-00-00#497-F-N-00-00-00-00#498-F-N-00-00-00-00#471-B-N-00-00-00-00#472-B-N-00-00-00-00#473-B-N-00-00-00-00#474-B-N-00-00-00-00#466-F-N-00-00-00-00#498-F-N-00-00-00-00#499-F-N-00-00-00-00#466-F-N-00-00-00-00#467-F-N-00-00-00-00#468-F-N-00-00-00-00#469-F-N-00-00-00-00#496-F-N-00-00-00-00#497-F-N-00-00-00-00#498-F-N-00-00-00-00#499-F-N-00-00-00-00#466-F-N-00-00-00-00#418-B-N-00-00-00-00#
446-B-N-00-00-00-00#469-F-N-00-00-00-00#496-F-N-00-00-00-00#497-F-N-00-00-00-00#498-F-N-00-00-00-00#499-F-N-00-00-00-00#466-F-N-00-00-00-00#467-F-N-00-00-00-00#468-F-N-00-00-00-00#469-F-N-00-00-00-00#496-F-N-00-00-00-00#497-F-N-00-00-00-00#498-F-N-00-00-00-00#499-F-N-00-00-00-00#466-F-N-00-00-00-00#467-F-N-00-00-00-00#468-F-N-00-00-00-00#469-F-N-00-00-00-00#496-F-N-00-00-00-00#497-F-N-00-00-00-00#498-F-N-00-00-00-00#499-F-N-00-00-00-00#466-F-N-00-00-00-00#467-F-N-00-00-00-00#468-F-N-00-00-00-00#469-F-N-00-00-00-00#496-F-N-00-00-00-00#497-F-N-00-00-00-00#498-F-N-00-00-00-00#499-F-N-00-00-00-00#466-F-N-00-00-00-00#450-B-N-00-00-00-00#468-F-N-00-00-00-00#469-F-N-00-00-00-00#496-F-N-00-00-00-00#497-F-N-00-00-00-00#498-F-N-00-00-00-00#499-F-N-00-00-00-00#466-F-N-00-00-00-00#467-F-N-00-00-00-00#468-F-N-00-00-00-00#469-F-N-00-00-00-00#496-F-N-00-00-00-00#497-F-N-00-00-00-00#498-F-N-00-00-00-00#499-F-N-00-00-00-00#468-F-N-00-00-00-00#469-F-N-00-00-00-00#496-F-N-00-00-00-00#497-F-N-00-00-00-00#498-F-N-00-00-00-00#499-F-N-00-00-00-00#466-F-N-00-00-00-00#467-F-N-00-00-00-00#468-F-N-00-00-00-00#469-F-N-00-00-00-00#496-F-N-00-00-00-00#497-F-N-00-00-00-00#498-F-N-00-00-00-00#448-B-N-00-00-00-00#
125-B-N-00-00-00-00#467-F-N-00-00-00-00#468-F-N-00-00-00-00#469-F-N-00-00-00-00#496-F-N-00-00-00-00#497-F-N-00-00-00-00#498-F-N-00-00-00-00#499-F-N-00-00-00-00#466-F-N-00-00-00-00#467-F-N-00-00-00-00#468-F-N-00-00-00-00#469-F-N-00-00-00-00#496-F-N-00-00-00-00#497-F-N-00-00-00-00#498-F-N-00-00-00-00#499-F-N-00-00-00-00#466-F-N-00-00-00-00#467-F-N-00-00-00-00#468-F-N-00-00-00-00#469-F-N-00-00-00-00#496-F-N-00-00-00-00#497-F-N-00-00-00-00#498-F-N-00-00-00-00#499-F-N-00-00-00-00#466-F-N-00-00-00-00#467-F-N-00-00-00-00#468-F-N-00-00-00-00#469-F-N-00-00-00-00#496-F-F-00-00-00-00#497-F-N-00-00-00-00#498-F-N-00-00-00-00#480-B-N-00-00-00-00#466-F-N-00-00-00-00#467-F-N-00-00-00-00#468-F-N-00-00-00-00#469-F-N-00-00-00-00#496-F-N-00-00-00-00#497-F-N-00-00-00-00#498-F-N-00-00-00-00#499-F-N-00-00-00-00#466-F-N-00-00-00-00#467-F-N-00-00-00-00#468-F-N-00-00-00-00#469-F-N-00-00-00-00#496-F-N-00-00-00-00#497-F-N-00-00-00-00#466-F-N-00-00-00-00#467-F-N-00-00-00-00#468-F-N-00-00-00-00#471-B-N-00-00-00-00#472-B-N-00-00-00-00#473-B-N-00-00-00-00#474-B-N-00-00-00-00#499-F-N-00-00-00-00#466-F-N-00-00-00-00#467-F-N-00-00-00-00#468-F-N-00-00-00-00#469-F-N-00-00-00-00#496-F-N-00-00-00-00#478-B-N-00-00-00-00#
466-F-A-00-00-00-00#499-F-N-00-00-00-00#466-F-N-00-00-00-00#467-F-N-00-00-00-00#468-F-N-00-00-00-00#469-F-N-00-00-00-00#496-F-N-00-00-00-00#497-F-N-00-00-00-00#498-F-N-00-00-00-00#499-F-N-00-00-00-00#466-F-N-00-00-00-00#467-F-N-00-00-00-00#468-F-N-00-00-00-00#469-F-N-00-00-00-00#496-F-N-00-00-00-00#497-F-N-00-00-00-00#498-F-N-00-00-00-00#499-F-N-00-00-00-00#466-F-N-00-00-00-00#467-F-N-00-00-00-00#468-F-N-00-00-00-00#469-F-N-00-00-00-00#496-F-N-00-00-00-00#497-F-N-00-00-00-00#498-F-N-00-00-00-00#499-F-N-00-00-00-00#466-F-N-00-00-00-00#467-F-N-00-00-00-00#468-F-N-00-00-00-00#469-F-N-00-00-00-00#496-F-N-00-00-00-00#102-B-N-00-00-00-00#498-F-N-00-00-00-00#499-F-N-00-00-00-00#466-F-N-00-00-00-00#467-F-N-00-00-00-00#468-F-N-00-00-00-00#469-F-N-00-00-00-00#496-F-N-00-00-00-00#497-F-N-00-00-00-00#498-F-N-00-00-00-00#499-F-N-00-00-00-00#466-F-N-00-00-00-00#467-F-N-00-00-00-00#468-F-N-00-00-00-00#469-F-N-00-00-00-00#498-F-N-00-00-00-00#499-F-N-00-00-00-00#466-F-N-00-00-00-00#467-F-N-00-00-00-00#468-F-N-00-00-00-00#469-F-N-00-00-00-00#496-F-N-00-00-00-00#497-F-N-00-00-00-00#498-F-N-00-00-00-00#499-F-N-00-00-00-00#466-F-N-00-00-00-00#467-F-N-00-00-00-00#468-F-N-00-00-00-00#508-B-N-00-00-00-00#
466-F-A-00-00-00-00#497-F-N-00-00-00-00#498-F-N-00-00-00-00#499-F-N-00-00-00-00#466-F-N-00-00-00-00#467-F-N-00-00-00-00#468-F-N-00-00-00-00#469-F-N-00-00-00-00#496-F-N-00-00-00-00#497-F-N-00-00-00-00#498-F-N-00-00-00-00#499-F-N-00-00-00-00#466-F-N-00-00-00-00#467-F-N-00-00-00-00#468-F-N-00-00-00-00#469-F-N-00-00-00-00#496-F-N-00-00-00-00#497-F-N-00-00-00-00#498-F-N-00-00-00-00#499-F-N-00-00-00-00#466-F-N-00-00-00-00#467-F-N-00-00-00-00#468-F-N-00-00-00-00#469-F-N-00-00-00-00#496-F-N-00-00-00-00#497-F-N-00-00-00-00#498-F-N-00-00-00-00#499-F-N-00-00-00-00#466-F-N-00-00-00-00#467-F-N-00-00-00-00#468-F-N-00-00-00-00#469-F-N-00-00-00-00#496-F-N-00-00-00-00#497-F-N-00-00-00-00#498-F-N-00-00-00-00#499-F-N-00-00-00-00#466-F-N-00-00-00-00#471-B-N-00-00-00-00#472-B-N-00-00-00-00#473-B-N-00-00-00-00#474-B-N-00-00-00-00#466-F-N-00-00-00-00#498-F-N-00-00-00-00#499-F-N-00-00-00-00#466-F-N-00-00-00-00#467-F-N-00-00-00-00#496-F-N-00-00-00-00#497-F-N-00-00-00-00#498-F-N-00-00-00-00#499-F-N-00-00-00-00#466-F-N-00-00-00-00#467-F-N-00-00-00-00#468-F-N-00-00-00-00#469-F-N-00-00-00-00#496-F-N-00-00-00-00#497-F-N-00-00-00-00#498-F-N-00-00-00-00#499-F-N-00-00-00-00#466-F-N-00-00-00-00#538-B-N-00-00-00-00#
331-B-N-00-00-00-00#473-B-N-00-00-00-00#474-B-N-00-00-00-00#497-F-N-00-00-00-00#498-F-N-00-00-00-00#499-F-N-00-00-00-00#466-F-N-00-00-00-00#467-F-N-00-00-00-00#468-F-N-00-00-00-00#469-F-N-00-00-00-00#496-F-N-00-00-00-00#497-F-N-00-00-00-00#498-F-N-00-00-00-00#499-F-N-00-00-00-00#466-F-N-00-00-00-00#467-F-N-00-00-00-00#468-F-N-00-00-00-00#469-F-N-00-00-00-00#496-F-N-00-00-00-00#497-F-N-00-00-00-00#498-F-N-00-00-00-00#499-F-N-00-00-00-00#466-F-N-00-00-00-00#467-F-N-00-00-00-00#468-F-N-00-00-00-00#469-F-N-00-00-00-00#496-F-N-00-00-00-00#497-F-N-00-00-00-00#498-F-N-00-00-00-00#499-F-N-00-00-00-00#466-F-N-00-00-00-00#467-F-N-00-00-00-00#468-F-N-00-00-00-00#469-F-N-00-00-00-00#496-F-N-00-00-00-00#497-F-N-00-00-00-00#498-F-N-00-00-00-00#499-F-N-00-00-00-00#466-F-N-00-00-00-00#467-F-N-00-00-00-00#468-F-N-00-00-00-00#469-F-N-00-00-00-00#496-F-N-00-00-00-00#497-F-N-00-00-00-00#498-F-N-00-00-00-00#499-F-N-00-00-00-00#468-F-N-00-00-00-00#469-F-N-00-00-00-00#496-F-N-00-00-00-00#497-F-N-00-00-00-00#498-F-N-00-00-00-00#499-F-N-00-00-00-00#466-F-N-00-00-00-00#467-F-N-00-00-00-00#468-F-N-00-00-00-00#469-F-N-00-00-00-00#496-F-N-00-00-00-00#497-F-N-00-00-00-00#498-F-N-00-00-00-00#418-B-N-00-00-00-00#
416-B-N-00-00-00-00#467-F-N-00-00-00-00#468-F-N-00-00-00-00#469-F-N-00-00-00-00#496-F-N-00-00-00-00#497-F-N-00-00-00-00#498-F-N-00-00-00-00#499-F-N-00-00-00-00#466-F-N-00-00-00-00#467-F-N-00-00-00-00#468-F-N-00-00-00-00#469-F-N-00-00-00-00#496-F-N-00-00-00-00#497-F-N-00-00-00-00#498-F-N-00-00-00-00#499-F-N-00-00-00-00#466-F-N-00-00-00-00#467-F-N-00-00-00-00#468-F-N-00-00-00-00#469-F-N-00-00-00-00#496-F-N-00-00-00-00#497-F-N-00-00-00-00#498-F-N-00-00-00-00#499-F-N-00-00-00-00#466-F-N-00-00-00-00#467-F-N-00-00-00-00#468-F-N-00-00-00-00#469-F-N-00-00-00-00#496-F-N-00-00-00-00#497-F-N-00-00-00-00#498-F-N-00-00-00-00#63-B-N-00-00-00-00#473-B-N-00-00-00-00#97-B-N-00-00-00-00#468-F-N-00-00-00-00#469-F-N-00-00-00-00#496-F-N-00-00-00-00#497-F-N-00-00-00-00#498-F-N-00-00-00-00#466-F-N-00-00-00-00#466-F-N-00-00-00-00#467-F-N-00-00-00-00#468-F-N-00-00-00-00#469-F-N-00-00-00-00#496-F-N-00-00-00-00#497-F-N-00-00-00-00#466-F-N-00-00-00-00#467-F-N-00-00-00-00#468-F-N-00-00-00-00#469-F-N-00-00-00-00#496-F-N-00-00-00-00#497-F-N-00-00-00-00#498-F-N-00-00-00-00#499-F-N-00-00-00-00#466-F-N-00-00-00-00#467-F-N-00-00-00-00#468-F-N-00-00-00-00#469-F-N-00-00-00-00#496-F-N-00-00-00-00#448-B-N-00-00-00-00#
446-B-N-00-00-00-00#499-F-N-00-00-00-00#466-F-N-00-00-00-00#467-F-N-00-00-00-00#466-F-N-00-00-00-00#466-F-N-00-00-00-00#466-F-N-00-00-00-00#466-F-E-00-00-00-00#498-F-N-00-00-00-00#499-F-N-00-00-00-00#466-F-N-00-00-00-00#467-F-N-00-00-00-00#468-F-N-00-00-00-00#469-F-N-00-00-00-00#496-F-N-00-00-00-00#497-F-N-00-00-00-00#498-F-F-00-00-00-00#499-F-N-00-00-00-00#466-F-N-00-00-00-00#467-F-N-00-00-00-00#468-F-N-00-00-00-00#469-F-N-00-00-00-00#496-F-N-00-00-00-00#497-F-N-00-00-00-00#498-F-N-00-00-00-00#499-F-N-00-00-00-00#466-F-N-00-00-00-00#467-F-N-00-00-00-00#468-F-N-00-00-00-00#469-F-N-00-00-00-00#496-F-N-00-00-00-00#450-B-N-00-00-00-00#466-F-N-00-00-00-00#466-F-N-00-00-00-00#466-F-N-00-00-00-00#467-F-N-00-00-00-00#468-F-N-00-00-00-00#469-F-N-00-00-00-00#496-F-N-00-00-00-00#497-F-N-00-00-00-00#498-F-N-00-00-00-00#499-F-N-00-00-00-00#466-F-N-00-00-00-00#467-F-N-00-00-00-00#468-F-N-00-00-00-00#469-F-N-00-00-00-00#498-F-N-00-00-00-00#499-F-N-00-00-00-00#466-F-N-00-00-00-00#467-F-N-00-00-00-00#468-F-N-00-00-00-00#469-F-N-00-00-00-00#496-F-N-00-00-00-00#497-F-N-00-00-00-00#498-F-N-00-00-00-00#499-F-N-00-00-00-00#466-F-N-00-00-00-00#467-F-N-00-00-00-00#468-F-N-00-00-00-00#478-B-N-00-00-00-00#
476-B-N-00-00-00-00#497-F-N-00-00-00-00#498-F-N-00-00-00-00#499-F-N-00-00-00-00#471-B-N-00-00-00-00#472-B-N-00-00-00-00#473-B-N-00-00-00-00#474-B-N-00-00-00-00#496-F-N-00-00-00-00#497-F-N-00-00-00-00#498-F-N-00-00-00-00#499-F-N-00-00-00-00#466-F-N-00-00-00-00#467-F-N-00-00-00-00#468-F-N-00-00-00-00#469-F-N-00-00-00-00#496-F-N-00-00-00-00#497-F-N-00-00-00-00#498-F-N-00-00-00-00#499-F-N-00-00-00-00#466-F-N-00-00-00-00#467-F-N-00-00-00-00#468-F-N-00-00-00-00#469-F-N-00-00-00-00#496-F-N-00-00-00-00#497-F-N-00-00-00-00#498-F-N-00-00-00-00#499-F-N-00-00-00-00#466-F-N-00-00-00-00#467-F-N-00-00-00-00#468-F-N-00-00-00-00#480-B-N-00-00-00-00#466-F-N-00-00-00-00#466-F-N-00-00-00-00#498-F-N-00-00-00-00#499-F-N-00-00-00-00#466-F-N-00-00-00-00#467-F-N-00-00-00-00#468-F-N-00-00-00-00#469-F-N-00-00-00-00#496-F-N-00-00-00-00#497-F-N-00-00-00-00#498-F-N-00-00-00-00#471-B-N-00-00-00-00#472-B-N-00-00-00-00#473-B-N-00-00-00-00#474-B-N-00-00-00-00#497-F-N-00-00-00-00#498-F-N-00-00-00-00#499-F-N-00-00-00-00#466-F-N-00-00-00-00#467-F-N-00-00-00-00#468-F-N-00-00-00-00#469-F-N-00-00-00-00#496-F-N-00-00-00-00#497-F-N-00-00-00-00#498-F-N-00-00-00-00#499-F-N-00-00-00-00#466-F-N-00-00-00-00#508-B-N-00-00-00-00#
506-B-N-00-00-00-00#469-F-N-00-00-00-00#496-F-N-00-00-00-00#497-F-N-00-00-00-00#498-F-N-00-00-00-00#499-F-N-00-00-00-00#466-F-N-00-00-00-00#467-F-N-00-00-00-00#468-F-N-00-00-00-00#469-F-N-00-00-00-00#496-F-N-00-00-00-00#497-F-N-00-00-00-00#498-F-N-00-00-00-00#499-F-N-00-00-00-00#466-F-N-00-00-00-00#467-F-N-00-00-00-00#468-F-N-00-00-00-00#469-F-N-00-00-00-00#496-F-N-00-00-00-00#497-F-N-00-00-00-00#498-F-N-00-00-00-00#499-F-N-00-00-00-00#466-F-N-00-00-00-00#467-F-N-00-00-00-00#468-F-N-00-00-00-00#469-F-N-00-00-00-00#496-F-N-00-00-00-00#497-F-N-00-00-00-00#498-F-N-00-00-00-00#499-F-N-00-00-00-00#466-F-N-00-00-00-00#510-B-N-00-00-00-00#466-F-N-00-00-00-00#466-F-N-00-00-00-00#496-F-N-00-00-00-00#497-F-N-00-00-00-00#498-F-N-00-00-00-00#499-F-N-00-00-00-00#466-F-N-00-00-00-00#467-F-N-00-00-00-00#468-F-N-00-00-00-00#469-F-N-00-00-00-00#496-F-N-00-00-00-00#497-F-N-00-00-00-00#498-F-N-00-00-00-00#499-F-N-00-00-00-00#468-F-N-00-00-00-00#469-F-N-00-00-00-00#496-F-N-00-00-00-00#497-F-N-00-00-00-00#498-F-N-00-00-00-00#499-F-N-00-00-00-00#466-F-N-00-00-00-00#467-F-N-00-00-00-00#468-F-N-00-00-00-00#469-F-N-00-00-00-00#496-F-N-00-00-00-00#497-F-N-00-00-00-00#498-F-N-00-00-00-00#538-B-N-00-00-00-00#
536-B-N-00-00-00-00#467-F-N-00-00-00-00#468-F-N-00-00-00-00#469-F-N-00-00-00-00#496-F-N-00-00-00-00#497-F-N-00-00-00-00#498-F-N-00-00-00-00#499-F-N-00-00-00-00#466-F-N-00-00-00-00#467-F-N-00-00-00-00#468-F-N-00-00-00-00#469-F-N-00-00-00-00#496-F-N-00-00-00-00#497-F-N-00-00-00-00#498-F-N-00-00-00-00#499-F-N-00-00-00-00#466-F-N-00-00-00-00#467-F-N-00-00-00-00#468-F-N-00-00-00-00#469-F-N-00-00-00-00#496-F-N-00-00-00-00#497-F-N-00-00-00-00#498-F-N-00-00-00-00#499-F-N-00-00-00-00#466-F-N-00-00-00-00#467-F-N-00-00-00-00#468-F-N-00-00-00-00#469-F-N-00-00-00-00#496-F-N-00-00-00-00#497-F-N-00-00-00-00#498-F-N-00-00-00-00#450-B-N-00-00-00-00#466-F-N-00-00-00-00#466-F-N-00-00-00-00#468-F-N-00-00-00-00#469-F-N-00-00-00-00#496-F-N-00-00-00-00#497-F-N-00-00-00-00#498-F-N-00-00-00-00#499-F-N-00-00-00-00#466-F-N-00-00-00-00#467-F-N-00-00-00-00#468-F-N-00-00-00-00#469-F-N-00-00-00-00#496-F-N-00-00-00-00#497-F-N-00-00-00-00#466-F-N-00-00-00-00#467-F-N-00-00-00-00#468-F-N-00-00-00-00#469-F-N-00-00-00-00#496-F-N-00-00-00-00#497-F-N-00-00-00-00#498-F-N-00-00-00-00#499-F-N-00-00-00-00#466-F-N-00-00-00-00#467-F-N-00-00-00-00#468-F-N-00-00-00-00#469-F-N-00-00-00-00#496-F-N-00-00-00-00#418-B-N-00-00-00-00#
416-B-N-00-00-00-00#499-F-N-00-00-00-00#466-F-N-00-00-00-00#467-F-N-00-00-00-00#468-F-N-00-00-00-00#469-F-N-00-00-00-00#496-F-N-00-00-00-00#497-F-N-00-00-00-00#498-F-N-00-00-00-00#499-F-N-00-00-00-00#471-B-N-00-00-00-00#472-B-N-00-00-00-00#473-B-N-00-00-00-00#474-B-N-00-00-00-00#496-F-N-00-00-00-00#497-F-N-00-00-00-00#498-F-N-00-00-00-00#499-F-N-00-00-00-00#466-F-N-00-00-00-00#467-F-N-00-00-00-00#468-F-N-00-00-00-00#466-F-N-00-00-00-00#466-F-N-00-00-00-00#466-F-N-00-00-00-00#466-F-N-00-00-00-00#499-F-F-00-00-00-00#466-F-N-00-00-00-00#467-F-N-00-00-00-00#468-F-N-00-00-00-00#469-F-N-00-00-00-00#496-F-N-00-00-00-00#480-B-N-00-00-00-00#466-F-N-00-00-00-00#466-F-N-00-00-00-00#466-F-N-00-00-00-00#467-F-N-00-00-00-00#468-F-N-00-00-00-00#469-F-N-00-00-00-00#496-F-N-00-00-00-00#497-F-N-00-00-00-00#498-F-N-00-00-00-00#499-F-N-00-00-00-00#466-F-N-00-00-00-00#467-F-N-00-00-00-00#468-F-N-00-00-00-00#469-F-N-00-00-00-00#498-F-N-00-00-00-00#499-F-N-00-00-00-00#466-F-N-00-00-00-00#467-F-N-00-00-00-00#468-F-N-00-00-00-00#469-F-N-00-00-00-00#496-F-N-00-00-00-00#497-F-N-00-00-00-00#498-F-N-00-00-00-00#499-F-N-00-00-00-00#466-F-N-00-00-00-00#467-F-N-00-00-00-00#468-F-N-00-00-00-00#448-B-N-00-00-00-00#
446-B-N-00-00-00-00#497-F-N-00-00-00-00#498-F-N-00-00-00-00#499-F-N-00-00-00-00#466-F-N-00-00-00-00#467-F-N-00-00-00-00#468-F-N-00-00-00-00#469-F-N-00-00-00-00#496-F-N-00-00-00-00#497-F-N-00-00-00-00#498-F-N-00-00-00-00#499-F-N-00-00-00-00#466-F-N-00-00-00-00#467-F-N-00-00-00-00#468-F-N-00-00-00-00#469-F-N-00-00-00-00#496-F-N-00-00-00-00#497-F-N-00-00-00-00#498-F-N-00-00-00-00#499-F-N-00-00-00-00#466-F-N-00-00-00-00#467-F-N-00-00-00-00#468-F-N-00-00-00-00#469-F-N-00-00-00-00#496-F-N-00-00-00-00#497-F-N-00-00-00-00#498-F-N-00-00-00-00#499-F-N-00-00-00-00#466-F-N-00-00-00-00#467-F-N-00-00-00-00#468-F-N-00-00-00-00#510-B-N-00-00-00-00#466-F-N-00-00-00-00#466-F-N-00-00-00-00#466-F-N-00-00-00-00#499-F-N-00-00-00-00#466-F-N-00-00-00-00#467-F-N-00-00-00-00#468-F-N-00-00-00-00#469-F-N-00-00-00-00#496-F-N-00-00-00-00#497-F-N-00-00-00-00#498-F-N-00-00-00-00#499-F-N-00-00-00-00#466-F-N-00-00-00-00#467-F-N-00-00-00-00#496-F-N-00-00-00-00#497-F-N-00-00-00-00#498-F-N-00-00-00-00#471-B-N-00-00-00-00#472-B-N-00-00-00-00#473-B-N-00-00-00-00#474-B-N-00-00-00-00#469-F-N-00-00-00-00#496-F-N-00-00-00-00#497-F-N-00-00-00-00#498-F-N-00-00-00-00#499-F-N-00-00-00-00#466-F-N-00-00-00-00#478-B-N-00-00-00-00#
476-B-N-00-00-00-00#469-F-N-00-00-00-00#496-F-N-00-00-00-00#497-F-N-00-00-00-00#498-F-E-00-00-00-00#499-F-N-00-00-00-00#466-F-N-00-00-00-00#467-F-N-00-00-00-00#468-F-N-00-00-00-00#469-F-N-00-00-00-00#496-F-N-00-00-00-00#497-F-N-00-00-00-00#498-F-N-00-00-00-00#499-F-N-00-00-00-00#466-F-N-00-00-00-00#467-F-N-00-00-00-00#468-F-N-00-00-00-00#469-F-N-00-00-00-00#496-F-N-00-00-00-00#497-F-N-00-00-00-00#498-F-N-00-00-00-00#499-F-N-00-00-00-00#466-F-N-00-00-00-00#467-F-N-00-00-00-00#468-F-N-00-00-00-00#469-F-N-00-00-00-00#496-F-N-00-00-00-00#497-F-N-00-00-00-00#498-F-N-00-00-00-00#499-F-N-00-00-00-00#466-F-N-00-00-00-00#450-B-N-00-00-00-00#466-F-N-00-00-00-00#466-F-N-00-00-00-00#496-F-N-00-00-00-00#497-F-N-00-00-00-00#498-F-N-00-00-00-00#499-F-N-00-00-00-00#466-F-N-00-00-00-00#467-F-N-00-00-00-00#468-F-N-00-00-00-00#469-F-N-00-00-00-00#496-F-N-00-00-00-00#497-F-N-00-00-00-00#498-F-N-00-00-00-00#499-F-N-00-00-00-00#468-F-N-00-00-00-00#469-F-N-00-00-00-00#496-F-N-00-00-00-00#497-F-N-00-00-00-00#498-F-N-00-00-00-00#499-F-N-00-00-00-00#466-F-N-00-00-00-00#467-F-N-00-00-00-00#468-F-N-00-00-00-00#469-F-N-00-00-00-00#496-F-N-00-00-00-00#497-F-N-00-00-00-00#498-F-N-00-00-00-00#508-B-N-00-00-00-00#
96-B-N-00-00-00-00#472-B-N-00-00-00-00#472-B-N-00-00-00-00#473-B-N-00-00-00-00#474-B-N-00-00-00-00#497-F-N-00-00-00-00#498-F-N-00-00-00-00#499-F-N-00-00-00-00#466-F-N-00-00-00-00#467-F-N-00-00-00-00#468-F-N-00-00-00-00#469-F-N-00-00-00-00#496-F-N-00-00-00-00#497-F-N-00-00-00-00#498-F-N-00-00-00-00#499-F-N-00-00-00-00#466-F-N-00-00-00-00#467-F-N-00-00-00-00#468-F-N-00-00-00-00#469-F-N-00-00-00-00#496-F-N-00-00-00-00#497-F-N-00-00-00-00#498-F-N-00-00-00-00#499-F-N-00-00-00-00#466-F-N-00-00-00-00#467-F-N-00-00-00-00#468-F-N-00-00-00-00#469-F-N-00-00-00-00#496-F-N-00-00-00-00#497-F-N-00-00-00-00#498-F-N-00-00-00-00#480-B-N-00-00-00-00#466-F-N-00-00-00-00#466-F-N-00-00-00-00#468-F-N-00-00-00-00#469-F-N-00-00-00-00#496-F-N-00-00-00-00#497-F-N-00-00-00-00#498-F-N-00-00-00-00#499-F-N-00-00-00-00#466-F-N-00-00-00-00#467-F-N-00-00-00-00#468-F-N-00-00-00-00#469-F-N-00-00-00-00#496-F-N-00-00-00-00#497-F-N-00-00-00-00#466-F-N-00-00-00-00#467-F-N-00-00-00-00#468-F-N-00-00-00-00#469-F-N-00-00-00-00#496-F-N-00-00-00-00#497-F-N-00-00-00-00#498-F-N-00-00-00-00#499-F-N-00-00-00-00#466-F-N-00-00-00-00#467-F-N-00-00-00-00#468-F-N-00-00-00-00#469-F-N-00-00-00-00#496-F-N-00-00-00-00#538-B-N-00-00-00-00#
416-B-N-00-00-00-00#499-F-N-00-00-00-00#466-F-N-00-00-00-00#467-F-N-00-00-00-00#468-F-N-00-00-00-00#469-F-N-00-00-00-00#496-F-N-00-00-00-00#497-F-N-00-00-00-00#498-F-N-00-00-00-00#499-F-N-00-00-00-00#466-F-N-00-00-00-00#467-F-N-00-00-00-00#468-F-N-00-00-00-00#469-F-N-00-00-00-00#496-F-N-00-00-00-00#497-F-N-00-00-00-00#498-F-N-00-00-00-00#499-F-N-00-00-00-00#466-F-N-00-00-00-00#467-F-N-00-00-00-00#468-F-N-00-00-00-00#469-F-N-00-00-00-00#496-F-N-00-00-00-00#497-F-N-00-00-00-00#498-F-N-00-00-00-00#499-F-N-00-00-00-00#466-F-N-00-00-00-00#467-F-N-00-00-00-00#468-F-N-00-00-00-00#469-F-N-00-00-00-00#496-F-N-00-00-00-00#510-B-N-00-00-00-00#466-F-N-00-00-00-00#466-F-N-00-00-00-00#466-F-N-00-00-00-00#467-F-N-00-00-00-00#468-F-N-00-00-00-00#469-F-N-00-00-00-00#496-F-N-00-00-00-00#497-F-N-00-00-00-00#498-F-N-00-00-00-00#499-F-N-00-00-00-00#466-F-N-00-00-00-00#467-F-N-00-00-00-00#468-F-N-00-00-00-00#469-F-N-00-00-00-00#498-F-N-00-00-00-00#499-F-N-00-00-00-00#466-F-N-00-00-00-00#467-F-N-00-00-00-00#468-F-N-00-00-00-00#469-F-N-00-00-00-00#496-F-N-00-00-00-00#497-F-N-00-00-00-00#471-B-N-00-00-00-00#472-B-N-00-00-00-00#473-B-N-00-00-00-00#474-B-N-00-00-00-00#468-F-N-00-00-00-00#418-B-N-00-00-00-00#
446-B-N-00-00-00-00#497-F-N-00-00-00-00#498-F-N-00-00-00-00#499-F-E-00-00-00-00#466-F-N-00-00-00-00#467-F-N-00-00-00-00#468-F-N-00-00-00-00#469-F-N-00-00-00-00#496-F-E-00-00-00-00#497-F-N-00-00-00-00#498-F-N-00-00-00-00#499-F-N-00-00-00-00#466-F-N-00-00-00-00#467-F-N-00-00-00-00#468-F-N-00-00-00-00#469-F-N-00-00-00-00#496-F-N-00-00-00-00#497-F-E-00-00-00-00#498-F-N-00-00-00-00#499-F-N-00-00-00-00#466-F-N-00-00-00-00#467-F-N-00-00-00-00#468-F-N-00-00-00-00#469-F-N-00-00-00-00#496-F-N-00-00-00-00#497-F-N-00-00-00-00#498-F-N-00-00-00-00#499-F-E-00-00-00-00#466-F-N-00-00-00-00#467-F-N-00-00-00-00#468-F-N-00-00-00-00#450-B-N-00-00-00-00#466-F-N-00-00-00-00#466-F-N-00-00-00-00#498-F-N-00-00-00-00#466-F-N-00-00-00-00#466-F-N-00-00-00-00#467-F-N-00-00-00-00#468-F-N-00-00-00-00#469-F-N-00-00-00-00#496-F-N-00-00-00-00#497-F-N-00-00-00-00#498-F-N-00-00-00-00#499-F-N-00-00-00-00#466-F-N-00-00-00-00#467-F-N-00-00-00-00#496-F-N-00-00-00-00#497-F-N-00-00-00-00#498-F-N-00-00-00-00#499-F-N-00-00-00-00#466-F-N-00-00-00-00#467-F-N-00-00-00-00#468-F-N-00-00-00-00#469-F-N-00-00-00-00#496-F-N-00-00-00-00#497-F-N-00-00-00-00#498-F-N-00-00-00-00#499-F-N-00-00-00-00#466-F-N-00-00-00-00#448-B-N-00-00-00-00#
342-B-N-00-00-00-00#331-B-N-00-00-00-00#332-B-N-00-00-00-00#333-B-N-00-00-00-00#334-B-N-00-00-00-00#335-B-N-00-00-00-00#336-B-N-00-00-00-00#337-B-N-00-00-00-00#338-B-N-00-00-00-00#339-B-N-00-00-00-00#340-B-N-00-00-00-00#333-B-N-00-00-00-00#340-B-N-00-00-00-00#331-B-N-00-00-00-00#332-B-N-00-00-00-00#333-B-N-00-00-00-00#334-B-N-00-00-00-00#335-B-N-00-00-00-00#336-B-N-00-00-00-00#337-B-N-00-00-00-00#338-B-N-00-00-00-00#339-B-N-00-00-00-00#340-B-N-00-00-00-00#331-B-N-00-00-00-00#332-B-N-00-00-00-00#333-B-N-00-00-00-00#334-B-N-00-00-00-00#335-B-N-00-00-00-00#336-B-N-00-00-00-00#337-B-N-00-00-00-00#338-B-N-00-00-00-00#34-B-N-00-00-00-00#331-B-N-00-00-00-00#332-B-N-00-00-00-00#331-B-N-00-00-00-00#332-B-N-00-00-00-00#331-B-N-00-00-00-00#332-B-N-00-00-00-00#333-B-N-00-00-00-00#334-B-N-00-00-00-00#335-B-N-00-00-00-00#336-B-N-00-00-00-00#337-B-N-00-00-00-00#338-B-N-00-00-00-00#339-B-N-00-00-00-00#340-B-N-00-00-00-00#331-B-N-00-00-00-00#332-B-N-00-00-00-00#333-B-N-00-00-00-00#334-B-N-00-00-00-00#335-B-N-00-00-00-00#336-B-N-00-00-00-00#337-B-N-00-00-00-00#338-B-N-00-00-00-00#339-B-N-00-00-00-00#340-B-N-00-00-00-00#331-B-N-00-00-00-00#332-B-N-00-00-00-00#333-B-N-00-00-00-00#344-B-N-00-00-00-00#
